EventId,Detector0,Detector1,Detector2,Detector3,TotalEnergyAllDetectors
0,49,77,24,30,180
1,37,87,29,37,190
2,32,38,257,38,365
3,38,46,32,415,531
4,78,66,77,366,587
5,58,62,26,28,174
6,54,55,1311,69,1489
7,28,32,31,158,249
8,42,235,39,45,361
9,89,28,26,26,169
